############################
#......##..........##......#
#o####.##.########.##.####o#
#.####.##.########.##.####.#
#..........................#
###.##.#####.##.#####.##.###
//#.##.#####.##.#####.##.#//
###.##.#####.##.#####.##.###
$$ .##.......##.......##. $$
###.##### ######## #####.###
//#.##### ######## #####.#//
//#.                    .#//
//#.##### ===%%=== #####.#//
//#.##### =~~~~~~= #####.#//
//#.##    =~~~~~~=    ##.#//
//#.## ## =~~~~~~= ## ##.#//
###.## ## ======== ## ##.###
$$ .   ##          ##   . $$
###.######## ## ########.###
//#.######## ## ########.#//
//#.......   ##   .......#//
//#.#####.########.#####.#//
###.#####.########.#####.###
#............  ............#
#.####.#####.##.#####.####.#
#.####.#####.##.#####.####.#
#.####.##....##....##.####.#
#.####.##.########.##.####.#
#o####.##.########.##.####o#
#..........................#
############################
