############################
#............##............#
#.####.#####.##.#####.####.#
#o####.#####.##.#####.####.#
#.####.#####.##.#####.####.#
#..........................#
#.####.##.########.##.####.#
#.####.##.########.##.####.#
#......##....##....##......#
######.##### ## #####.######
######.##### ## #####.######
     #.##          ##.#     
######.## ===%%=== ##.######
######.## =      = ##.######
      .   =      =   .      
######.## =      = ##.######
######.## ======== ##.######
     #.##          ##.#     
######.## ######## ##.######
######.## ######## ##.######
#............##............#
#.####.#####.##.#####.####.#
#.####.#####.##.#####.####.#
#o..##................##..o#
###.##.##.########.##.##.###
###.##.##.########.##.##.###
#......##....##....##......#
#.##########.##.##########.#
#.##########.##.##########.#
#..........................#
############################
