############################
#............##............#
#.####.#####.##.#####.####.#
#o####.#####.##.#####.####o#
#.####.#####.##.#####.####.#
#..........................#
#.####.##.########.##.####.#
#.####.##.########.##.####.#
#......##....##....##......#
######.##### ## #####.######
/////#.##### ## #####.#/////
/////#.##          ##.#/////
/////#.## ===%%=== ##.#/////
######.## =~~~~~~= ##.######
      .   =~~~~~~=   .      
######.## =~~~~~~= ##.######
/////#.## ======== ##.#/////
/////#.##          ##.#/////
/////#.## ######## ##.#/////
######.## ######## ##.######
#............##............#
#.####.#####.##.#####.####.#
#.####.#####.##.#####.####.#
#o..##.......  .......##..o#
###.##.##.########.##.##.###
###.##.##.########.##.##.###
#......##....##....##......#
#.##########.##.##########.#
#.##########.##.##########.#
#..........................#
############################
