############################
#............##............#
#.####.#####.##.#####.####.#
#o####.#####.##.#####.####o#
#.####.#####.##.#####.####.#
#..........................#
#.####.##.########.##.####.#
#.####.##.########.##.####.#
#......##....##....##......#
######.##### ## #####.######
     #.##### ## #####.#     
     #.##          ##.#     
     #.## ===%%=== ##.#     
######.## =      = ##.######
      .   =      =   .      
######.## =      = ##.######
     #.## ======== ##.#     
     #.##          ##.#     
     #.## ######## ##.#     
######.## ######## ##.######
#............##............#
#.####.#####.##.#####.####.#
#.####.#####.##.#####.####.#
#o..##................##..o#
###.##.##.########.##.##.###
###.##.##.########.##.##.###
#......##....##....##......#
#.##########.##.##########.#
#.##########.##.##########.#
#..........................#
############################
